NO ./textures/north.xpm
SO ./textures/south.xpm
WE ./textures/west.xpm
EA ./textures/east.xpm
F 50,50,50
C 180,200,255

1111111111
1000100001
1010101001
1000000001
1000N00001
1000000001
1000100001
1111111111
