NO ./textures/north.xpm
SO ./textures/south.xpm
WE ./textures/west.xpm
EA ./textures/east.xpm
DO ./textures/door1bamboo.xpm
F  50,50,50
C  120,120,150

111111111111111111111111111111111111111111111111111111111111111111111111
1N000000000000000000000000000000000000D000000000000000000000000000000001
111D111111110111111111111011111000200000111111111111111111D1111111101111
100010000001000000000001001000000010000000000000000100000000000000101111
101110111101111011111101101D11111010111000000000000100000000002000100011
100000100001000010000001001000001010000100111111111100000000000000100011
111110101111011110111101101111101011111100111111111100002000000000100111
100010101000000000100001001000001000000100000000000100000000000000100111
101010101011111110101111101011111011101100000000000111111111111111100111
100010001000002000100000001000002000001111111111111111111111111111111111
1111101111110111111110111111110111111111
1000001000000100000000100000000100000001
1011101011110101111110101111110101111101
1000101010000100000010100000100100000001
1110101010111110111010111110101110111011
1000100010000200100000100000100000100001
1011111110111110101111101111101110101111
1000000010000010100000001000001010100001
111111101111101011111110101111101D111111
1000001010000010000000101000000010000001
1011101010111110111110101011111110111011
1000100010000020100000101000000020000011
1110101111110110101110101011111D10111111
1000100000010000101000101000000010000001
101D111111011111101011101011111010111111
1000100001000000001000001000001010000001
1111101111011111111111111111111011111111
1000001000010000000200000000000010000001
1011111011110111111111111111111110111111
1111111111111111111111111111111111111111
