NO ./textures/north.xpm
SO ./textures/south.xpm
WE ./textures/west.xpm
EA ./textures/east.xpm
DO ./textures/door1bamboo.xpm
F  100,100,100
C  150,150,200

1111111111
1000000001
1011111101
1010000101
1010N01001
1000000001
1111111111
