NO ./textures/north.xpm
SO ./textures/south.xpm
WE ./textures/west.xpm
EA ./textures/east.xpm
F  100,100,100
C  150,150,150
11111111111111111111111111
1N000000000000000000000001
11101111101111101111111001
10000200000000002000000001
10111101111111101111111001
10000100000010000000001001
10000100020010002000001001
10110111111011111111001001
10010000000000000000001001
10010002000000002000001001
10111111101111111111001001
10000000001000000000001001
10002000001000000002001001
11101111101111111111001001
11111111111111111111111111
