NO ./textures/north.xpm
SO ./textures/south.xpm
WE ./textures/west.xpm
EA ./textures/east.xpm
DO ./textures/door1bamboo.xpm
F  100,100,100
C  150,150,200

1111111111111111111111111
10000000000000000000111
1000000000000000000000111
1111111110001111111111111
        100001
        100N01
        100001
        111111
